SSSSSSSSSSSSSSSS
SSSCSSXSSSSSSSSS
SSSPSSSCSLSSCSSS
SSSSSTTTSCSSCSTT
SSSSSTSSSSSSSSSS
SSSSSSCTTSSSSSCT
SCSSSSSSTCSSSSSS
STSSSSSTTTTTSSTT
SSSSSCSTTTTTTSST
SSSSSXSTTSSTSSSC
SSSSSSCSTSSSLSSS
SSTSSSSSSCSSSSSS
SSTCSSSSSTSSSSSS
SCTSSSSSSSSSSCSS
