SSSSSSSSSTTTSSSSSSSTTTTSSSSTCT
SSSCSSXSSSSSSSSSXCSSTTTTCSSSSS
SSSSSSSCSLSSCSSSSSTSSTSLSSSXSS
SSSSSTTTSCSSLSTTSSSSSSSLLSSSSS
SSSSSTSSSXSSSSSSSXSSSSXSLSSSSS
SSSSSSCTTSSSPSSTSSCSSSCSSSSXSS
SCSSSSSSTCSSSSSSCSSSXSSCTSSSSS
STSSSSSTTTTTSSTTSSSXSSSSSSSSTT
SSSSSCSTTTTTTSSTSSSCSSSTTTSSTC
SSSSSXSTTSSTSSSCSSSSSSSTTSSSSS
TTTLSSCSTSSSLSSSSSSLSSSSSSSSSS
SSTSSSSSSCSSSSSXSSTTSSSXSSSSSS
SSTCSXSSSTSSSSSSSSTTTSSCSSSSXL
SCTSSTTSSSSSSCSSSSSTTSSSXSTSSC
XSSSSCTTTSSSSSSSSSSTCSSSSSTTSS
