SSSSSSSSSSSSSSSS
SSSCSSXSSSSSSSSS
SSSSSSSCSLPSCSSS
SSSSSTTTSCSSCSTT
SSSSSTSSSSSSSSSS
SSSSSSCTTSSSSSCT
SCSSSSSSTCSFSSSS
STSFFSSTTTTTSSTT
SSSSSCSTTTTTTSST
SSSSSXSTTSSTSSSC
SSSSSSCSTSSSLSSS
SSTSSSSSSCSSSSSS
SSTCSFFSSTSFFSSS
SCTSSSFSSSSSSCSS
SSSSLSSSSSSSSSFF
SSFSFFSCSSSCSSFF
